ui_storyboard.text was created: 8/8/2021 8:53:59 PM
Filesize is: 8432 bytes

Debug
Group 0
SubMenuTitle - ストーリーボードメニュー
AnimeTest - アニメテスト
CtrlTest - 表示制御テスト

Group 1


Board
Group 0
Title - ストーリーボード
HintClose - 捜索不可能なマター
HintOpen - 捜索可能なマター
HintAchieved - 捜索済みのマター
HintAccepted - 捜索中のマター
HintGuide - ガイド中のマター
HintKeyOpen - 捜索可能なキーマター
HintKeyAchieved - 捜索済みのキーマター
HintKeyAccepted - 捜索中のキーマター
HintKeyGuide - ガイド中のキーマター
PercentComplete - 達成率

Group 1


Info
Group 0
Title - マター情報
SynopsisTitle - このイベントのあらすじ
OrderName - $(0)－$(1) $(2)
Info - 情報
Target - この先のルートの解放条件
Reward - クリア報酬
Crushing - 「$(0)」の撃破
Kills - $(0)
Achievement - 「$(0)」の達成
Conversation - 「$name)」との会話
ClientOrder - クライアントオーダー
Requester - 依頼者：$(0)
Location - 場所：$(0)・$(1)
Broadcasting - アニメ版PSO2の放送
BroadcastDate - 放送日時：$(0)
Broadcaster - 放送局：$(0)
StoryQuestClear - ストーリークエストのクリア
StoryQuestName - クエスト名：$(0)
EventBrowse - イベントの閲覧
EventName - イベント名：$(0)
Close_Vita - 捜索不可
Open_Vita - 捜索可能
Accepted_Vita - 捜索中
Achieved - 捜索済み
DetailsTitle1 - クリア報酬
DetailsTitle2 - イベント情報
SearchGauge - 進行状況
SearchGaugeRate - $(0)/$(1) 
StoryQuestRankTitle - ランク選択
StoryQuestRankNormal - カジュアル
StoryQuestRankHard - ハードコア

Group 1
StoryQuestRankTitle - SELECT RANK
StoryQuestRankNormal - Casual
StoryQuestRankHard - Hardcore


Message
Group 0
AcceptTitle - 捜索開始確認
Accept1 - このマターの捜索を開始しますか？
Accept2 - 捜索中のマターを変更し、<br>このマターの捜索を開始しますか？
Accept3 - クエストカウンターで<br>このマターのガイドを表示しますか？
Accept4 - このマターの対象キャラクターに<br>ガイドを表示しますか？
Target - 目標：
Area - 主なエリア：
Guide - （このマターをガイドの対象にした場合、<br>　このマターボードが捜索対象となります）
AutoGuide - おすすめのマター「$(0)－$(1) $(2)」にガイドを設定しました。
AcceptPopup1 - ストーリークエスト受注
AcceptPopup2 - クエストレコードを見る
MessageTitle - メッセージ
WindowTitle - クエスト受注確認
EventTitle - イベント再生
QuestMessage - ストーリークエストを受注して<br>キャンプシップへ移動します。<br>よろしいですか？
QuestSettledMessage - ストーリークエストを受注して<br>キャンプシップへ移動します。<br>よろしいですか？<br><br>　<c ffa800>※このクエストはクリア済みです<c>
QuestNotice - ストーリークエストを受注しますがよろしいですか？<br>　<yellow>※このクエストではキャンプシップには行かず<br>　　　直接フィールドへ移動します<c><br>───────────────────────<br>失敗条件/戦闘不能後、リタイアを選択
QuestSettledNotice - ストーリークエストを受注しますがよろしいですか？<br>　<yellow>※このクエストではキャンプシップには行かず<br>　　　直接フィールドへ移動します<c><br><br>　<c ffa800>※このクエストはクリア済みです<c><br>───────────────────────<br>失敗条件/戦闘不能後、リタイアを選択
QuestNoticeHard - ストーリークエストを受注しますがよろしいですか？<br>　<yellow>※このクエストではキャンプシップには行かず<br>　　　直接フィールドへ移動します<c><br>　<yellow>※ハードコアをクリアすると<br>　　　カジュアルにもクリアマークが付与されます<c><br>───────────────────────<br>失敗条件/戦闘不能後、リタイアを選択
QuestSettledNoticeHard - ストーリークエストを受注しますがよろしいですか？<br>　<yellow>※このクエストではキャンプシップには行かず<br>　　　直接フィールドへ移動します<c><br>　<yellow>※ハードコアをクリアすると<br>　　　カジュアルにもクリアマークが付与されます<c><br><br>　<c ffa800>※このクエストはクリア済みです<c><br>───────────────────────<br>失敗条件/戦闘不能後、リタイアを選択
QuestNoticeHard_F - ストーリークエストを受注しますがよろしいですか？<br>　<yellow>※このクエストではキャンプシップには行かず<br>　　　直接フィールドへ移動します<c><br>　<yellow>※このクエストにカジュアルはありません<c><br>───────────────────────<br>失敗条件/戦闘不能、制限時間の経過
QuestSettledNoticeHard_F - ストーリークエストを受注しますがよろしいですか？<br>　<yellow>※このクエストではキャンプシップには行かず<br>　　　直接フィールドへ移動します<c><br>　<yellow>※このクエストにカジュアルはありません<c><br><br>　<c ffa800>※このクエストはクリア済みです<c><br>───────────────────────<br>失敗条件/戦闘不能、制限時間の経過
BridgeMessage - ストーリークエストは艦橋でのみ受けられます。<br>　<yellow>※艦橋へはゲートエリア2F、または<br>　　クイックメニューの「艦橋へ行く」から移動できます。<c>
PartyMessage - ストーリークエストはパーティーを組んだ状態では<br>受注できません。
EventMessage - 選択したイベントを再生します。<br>よろしいですか？
EventSettledMessage - 選択したイベントを再生します。<br>よろしいですか？<br><br>　<c ffa800>※このイベントは閲覧済みです<c>
EventNotice - 艦橋以外の場所ではイベント閲覧ができません。<br>　<yellow>※艦橋へはゲートエリア2F、または<br>　　クイックメニューの「艦橋へ行く」から移動できます。<c>
MatterLock - このピースは、まだ解放されていません。
NonSynopsis - このピースにあらすじはありません。
GetReward - <c ffa800>達成報酬は受け取り済みです。<c>
CompleteTitle - 選択確認
Complete1 - このマターボードは、全てのマターが探索済みの<br>状態です。<br>このマターボードをセットすることで、ロビーにいる<br>キャラクターや会話の内容などが変化します。<br><br>マターボードのセットを変更しますか？
Complete2 - マターボードをセットしました。
MethodMessage - 特定のクエストをクリアすることで<br>この先に進むことができます。<br><br>「この先のルートの解放条件」ウィンドウ内の<br> <yellow>[クエスト名]<c> に書かれたクエストをクリアすることで<br>次のピースが解放されます。<br><br>※そのクエストがまだ出現していない場合は、<br>　他にまだクリアしていないクエストを<br>　進めてみてください。
MethodOrderMessage - 特定のクライアントオーダーを達成することで<br>この先に進むことができます。<br><br>右上の <yellow>[クライアントオーダー名]<c> に書かれた<br>オーダーを受注して、達成しましょう。<br><br>※そのオーダーがまだ出現していない場合は、<br>　他にまだ達成していないオーダーを<br>　進めてみてください。
ClearMessage - まとめて複数のルートが解放されました。

Group 1


